1111111111111111111111111111111111
1E0000000000000C00000C000000000001
1000101001000001010010000000101011
1P1000000C00C000000000000000X000C1
1111111111111111111111111111111111