11111111111111111111111111111111111111111111111
1P000000000000000000000000000000000000000000001
10111111111111111111X11011111111111111111111111
10100000000000000000000000000000000000000000001
10101111111111111111111111111111111111111111011
10101010000000000000000000000000C00000000000001
10101010101010101010101010101010101010101010101
10101010101010101010101010101010101010101010101
10101010101010101010101010101010101010101010101
101010101010101010101010101010101010101C1010101
10101010101010101010101010101010101010101010101
1010000000000000000000000000X000000000000000001
10111111100X11111110011111111000000000000000111
10101010101010000000000000001010101010101010101
101010101010100000000000000C1010101010101010101
101000000000100E0000000000001000000000000000001
1011100000001111111X011111111111111100000000001
10101010101010101010101010101010101010101010001
10101010101010101010101010101010101010101010101
10101010101010101010101010101010101010101010101
101000000C000000000000000000000000000000000C001
10101010101010101010101010101010101010101010101
101010101C1010101010101010101010101010101010101
10000000000000000000000000000000000000000000001
11111111111111111111111111111111111111111111111