11111111111111111111111111111111111111111111111111111111111111111111
1P000000000000000000000000000000000000000000000000000000C00000000011
10111111111111111111111111111111111111111111111111111111111111111011
10100000000000000000000000000000000000000000000000000000000000000001
10101111111111111111111111111111111111111111111111111111111101010101
10101010000000000000000000000000C00000000000000000000000000101010101
10101010101010101010101010101010101010101010101010101010101010101011
10101010101010101010101010101010101010101010101010101010101010101011
10101010101010101010101010101010101010101010101010101010101010101001
101010101010101010101010101010101010101C1010101010101010101010101001
10101010101010101010101010101010101010101010101010101010101010101001
1010000000000000000000000000X000000000000000000000000000000000001001
10111111111111111111111111111111111111111100111111111111111111111001
10101010101010101010101010101010101010101010101010101010101010101001
10101010101010101010101010101010101010101010101010101010101010101001
10100000000000000000000000000000000000000000000000000000000000001011
10111111111111111111111111111111111111111110011111111111111111111011
10101010101010101010101010101010101010101010001010101010101010101011
10101010101010101010101010101010101010101010101010101010101010101011
10101010101010101010101010101010101010101010101010101010101010101001
10101010101010101010101010101010101010101010101010101010101010101001
101000000C000000000000000000000000000000000C000000000000000000001001
10101010101010101010101010101010101010101010101010101010101010101001
101010101C1010101010101010101010101010101010101010101010101010101001
10111111111111111111111111111111111111111111111111111111111111111001
10101010101010101010101010101010101010101010101010101010101010101001
10100000000000000000000000000000000000000000000000000000000000001011
1E000000000X00000000000000000000000000000000000000000000000000000001
11111111111111111111111111111111111111111111111111111111111111111111